NO Xpm/bark.xpm
SO Xpm/bookshelf.xpm
WE Xpm/bricks.xpm
EA Xpm/gold.xpm

C 35,19,73
F 15,6,40

111111111111111
111111000111111
111110000011111
1111000S0001111
111000000000111
110000010000011
100000000000001
110000000000011
111000000000111
1111000000F1111
111110000011111
111111000111111
111111111111111
