F 76,76,76
C 99,99,99

NO Xpm/bark.xpm
SO Xpm/bookshelf.xpm
WE Xpm/bricks.xpm
EA Xpm/gold.xpm

1111111111111111111
1001001001001000001
1011000001000001001
10010010011D1101111
1001111000001001001
10000000000000ND001
10011111111D1001001
1111000000000001011
1000000001000000001
1111111111111111111
