NO Xpm/bark.xpm
SO Xpm/bookshelf.xpm
WE Xpm/bricks.xpm
EA Xpm/gold.xpm

F 164,169,20
C 153,204,255

111111111111111111111
100000000000000000001
100000000000000000001
100000000000000000001
100000000000000000001
100000000000000000001
100000000000000000001
100000000000000000001
100000000000000000001
100000000N00000000001
100000000000000000001
100000000000000000001
100000000000000000001
100000000000000000001
100000000000000000001
100000000000000000001
100000000000000000001
100000000000000000001
100000000000000000001
100000000000000000001
111111111111111111111
